.........
..##..#..
.##..###.
.#....#..
.#..p....
.#.......
.#....#..
.##..###.
..##..#..
.........