##########
#p.......#
#........#
#..#.....#
#...##...#
#....#.#.#
#...##.###
#.#....#.#
#........#
##########